XXXXXXXXXXXXXXXXXXXXX
XXXXXXXXXXXXXXXXXXXXX
XXXXXXXXXXXXXXXXXXXXX
XXXXXXXOXXXXXOXXXXXXX
XXXXXXXXXXXXX~~XXXXXX
XXX~~XXXXXXXXXXXXXXXX
XXXXXXX~XXXXXXXXXXXXX
XXXOXXX~X~OXXXXXXOXXX
XXXXXXXXX~*XXXXXXXXXX
XXXXXXXXX***XXXXX~XXX
XXXXXXXO**H**OXXX~XXX
XXXXXXXXX***XXXXXXXXX
XXXXXXXXXX*~~XXXXXXXX
XXXOXXXXXXOXXXXXXOXXX
XXXX~XXXXXXXXXXXXXXXX
XXXX~XXXX~~XXXXXXXXXX
XXXXXXXXXXXXXXXXXXXXX
XXXXXXXOXXXXXOXXXXXXX
XXXXXXXXXXXX~~XXXXXXX
XXXXXXXXXXXXXXXXXXXXX
XXXXXXXXXXXXXXXXXXXXX